███████████████████████████████████████████████████████████████████████████████████████████████████████████████████
██                 ██                 ██                 ██                 ██                 ██                  
██                 ██                 ██                 ██                                    ██                  
██                                    ██                 ██                                    ██                  
██                                    ██                 ██                                    ██                  
██                                    ██                 ██                                    ██                  
██                                    ██                 ██                                    ██                  
██                                    ██                                    ██                 ██                ██
██                 ██                 ██                                    ██                 ██                ██
██                 ██                 ██                                    ██                                   ██
██                 ██                 ██                                    ██                                   ██
██                 ██                 ██                                    ██                                   ██
██                 ██                                    ██                 ██                                   ██
██                 ██                                    ██                 ██                                   ██
██                 ██                                    ██                 ██                 ██                ██
██                 ██                                    ██                 ██                 ██                ██
██                 ██                                    ██                 ██                 ██                ██
██                 ██                 ██                 ██                 ██                 ██                ██
██                 ██                 ██                 ██                 ██                 ██                ██
███████████████████████████████████████████████████████████████████████████████████████████████████████████████████