                                                                                                                                                                                                                                   
                                                                                                                                                                                                                                   
                                                                                                                                                                                                                                   
        ╔═══════════════╗                                                                                                                                                                                                          
        ║               ║                                                                                                                                                                                                          
        ║               ║                                                                                                                                ╔══════════════════════════════╗                                          
        ╟─────░░░░░─────╢                                                                                                                                ║                              ║                                          
        ║               ║         ╔═══════════════╗                                                                                                      ║                              ║                                          
        ║               ║         ║               ║                                                                                                      ║                              ║                                          
        ║               ║         ║               ╚════════════╗                                                                                         ║                              ║                                          
        ║               ║         ║                            ║                                                                                         ║                              ║                                          
        ║               ║         ║                            ║                                                                                         ║                              ║                                          
        ║               ║         ║               ╔══════╗     ║                                                                                         ║                              ║                                          
        ║               ║         ║               ║      ║     ║                                                                                         ║                              ║                                          
        ║               ║         ╚════╗     ╔════╝      ║     ║                                                                                         ║                              ║                                          
        ║               ║              ║     ║           ║     ║                                                                                         ║                              ║                                          
        ║               ║             ░░░░░░░░░          ║     ║                                                                                         ║                              ║                                          
        ║               ║              ║     ║           ║     ║                                                                                         ║                              ║                                          
        ║               ╚══════════════╝     ║           ║     ║    ╔═══════════════╗                                                                    ║                              ║                                          
        ║                                    ║           ║     ║    ║               ║                                                                    ║                              ║                                          
        ║                                    ║           ║     ║    ║               ╚══════════════════════════════════════════════════════════════░░════╝                              ╚══░░═════════╗                            
        ║               ╔════════════════════╝           ║     ║    ║                                                                              ░░                                      ░░         ║                            
        ║               ║                                ║     ║    ║       X                                                                      ░░                                      ░░         ║                            
        ║               ║                                ║     ║    ║               ╔══════════════════════════════╗      ╔════════════════════════░░════╗                              ╔══░░══╗      ║                            
        ║               ║                                ║     ║    ║               ║                              ║      ║                              ╚══════════════════════════════╝      ║      ║                            
        ║               ║                                ║     ║    ╚═══════════════╝                              ║      ║                                                                    ║      ║                            
        ╚═══════════════╝                                ║     ║                                                   ║      ║                                                                    ║      ║                            
                                                         ║     ║                                                   ║      ║                                                                    ║      ║                            
                                                         ║     ║                                                   ║      ║                                                                    ║      ║                            
                                                         ║     ║                                                   ║      ║                                                                    ║      ║                            
                                                         ║     ║                                                   ║      ║                                                                    ║      ║                            
                                                         ║     ║                                                   ║      ║                                                                    ║      ║                            
                                                         ║     ╚═══════════════════════════════════════════════════╝      ║                                                                    ║      ║                            
                                                         ║                                                                ║                                                                    ║      ║                            
                                                         ║                                                                ║                                                                    ║      ║                            
                                                         ╚════════════════════════════════════════════════════════════════╝                                                                    ║      ║                            
                                                                                                                                                                                               ║      ║                            
                                                                                                                                                                                               ║      ║                            
                                                                                                                                                                                               ║      ║      ╔═══════════════╗     
                                                                                                                                                                                               ║      ║      ║               ║     
                                                                                                                                                                                               ║      ╚══════╝               ║     
                                                                                                                                                                                               ║                             ║     
                                                                                                                                                                                               ║                             ║     
                                                                                                                                                                                               ║      ╔══════╗               ║     
                                                                                                                                                                                               ║      ║      ║               ║     
                                                                                                                                                                                               ║      ║      ╚═══════════════╝     
                                                                                                                                                                                               ║      ║                            
                                                                                                                                                                                               ║      ║                            
                                                                                                                                                                                               ║      ║                            
                                                                                                                                                                                               ║      ║                            
                                                                                                                                                                                               ║      ║                            
                                                                                                                                                                                               ║      ║                            
                                                                                                                                                                                               ║      ║                            
                                                                                                                                                                                               ║      ║                            
                                                                                                                                                                                               ║      ║                            
                                                                                                                                                                                               ║      ║                            
                                                                                                                                                                                               ║      ║                            
                                                                                                                                         ████████████████████████████████                      ║      ║                            
                                                                                                                                         ██                            ██                      ║      ║                            
                                                                                                                                         ██                            ██                      ║      ║                            
                                                                                                                                         ██                            ██══════════════════════╝      ║                            
                                                                                                                                         ██                                                           ║                            
                                                                                                                                         ██                                                           ║                            
                                                                                                                                         ██                            ██═════════════════════════════╝                            
                                                                                                                                         ████████████████████████████████                                                          
                                                                                                                                                                                                                                   
                                                                                                                                                                                                                                   
                                                                                                                                                                                                                                   