███████████████████████████████████████████████████████████████████████████████████████████████████████████████████
██                 ██                        ████████████                        ██████████████████████████████████
██                 ██                        ████████████                        ██████████████████████████████████
██                 ██                        ████████████                        ██████████████████████████████████
██                 ██                        ████████████                        ██████████████████████████████████
██                 ██████████        ████████████████████████████        ██████████████████████████████████████████
██                                                                               ██████████████████████████████████
██                                                                               ██████████████████████████████████
██                                                                                                               ██
██                                                                                                               ██
██                                                                                                               ██
██                                                                                                               ██
██                                                                               ██████████████████████████████████
██                                                                               ██████████████████████████████████
██                 ██████████        ████████████████████████████        ██████████████████████████████████████████
██                 ██                        ████████████                        ██████████████████████████████████
██                 ██                        ████████████                        ██████████████████████████████████
██                 ██                        ████████████                        ██████████████████████████████████
██                 ██                        ████████████                        ██████████████████████████████████
███████████████████████████████████████████████████████████████████████████████████████████████████████████████████