███████████████████████████████████████████████████████████████████████████████████████████████████████████████████
██                 ██                 ██                 ██                 ██                 ██                ██
██                 ██                 ██                 ██                                    ██                ██
██                                    ██                 ██                                    ██                ██
██                                    ██                 ██                                    ██                ██
██                                    ██                 ██                                    ██                ██
██                                    ██                 ██                                    ██                ██
██                                    ██                                    ██                 ██                ██
██                 ██                 ██                                    ██                 ██                ██
██                 ██                 ██                                    ██                                   ██
██                 ██                 ██                                    ██                                   ██
██                 ██                 ██                                    ██                                   ██
██                 ██                                    ██                 ██                                   ██
██                 ██                                    ██                 ██                                   ██
██                 ██                                    ██                 ██                 ██                ██
██                 ██                                    ██                 ██                 ██                ██
██                 ██                                    ██                 ██                 ██                ██
██                 ██                 ██                 ██                 ██                 ██                ██
██                 ██                 ██                 ██                 ██                 ██                ██
███████████████████████████████████████████████████████████████████████████████████████████████████████████████████