███████████████████████████████████████████████████████████████████████████████████████████████████████████████████
██                 ██                                              ██                                            ██
██                 ██                                              ██                                            ██
██                                                                 ██                                            ██
██                                                                 ██                                            ██
██                                                                 ██                                            ██
██                                                                 ██                                            ██
██                                                                 ████████                                ████████
██                 ████████████████████████████████                                                              ██
██                 ████████████████████████████████                                                              ██
██                 ███                     ████████                                                              ██
██                 ███                     ████████                                                              ██
██                 ███                     ████████                                                              ██
██                 ███                     ████████                ████████                                      ██
██                 ███                                             ████████                                      ██
██                 ███                                             ████████                                      ██
██                 ███                                             ████████                                      ██
██                 ███                                             ████████                                      ██
██                 ███                                             ████████                                      ██
███████████████████████████████████████████████████████████████████████████████████████████████████████████████████