███████████████████████████████████████████████████████████████████████████████████████████████████████████████████
██                 ██                                              ██                                              
██                 ██                                              ██                                              
██                                                                 ██                                              
██                                                                 ██                                              
██                                                                 ██                                              
██                                                                 ██                                              
██                                                                 ████████                                ████████
██                 ████████████████████████████████                                                              ██
██                 ████████████████████████████████                                                              ██
██                 ███                     ████████                                  ╔═════════════╗             ██
██                 ███                     ████████                                  ║             ║             ██
██                 ███                     ████████                                  ║                           ██
██                 ███                     ████████                ████████          ║                           ██
██                 ███                                             ████████          ║                           ██
██                 ███                                             ████████          ║                           ██
██                 ███                                             ████████          ║                           ██
██                 ███                                             ████████          ║             ║             ██
██                 ███                                             ████████          ╚═════════════╝             ██
███████████████████████████████████████████████████████████████████████████████████████████████████████████████████