███████████████████████████████████████████████████████████████████████████████████████████████████████████████████████████████████████████████████████████████████████████████████████████████████████████████████████████████████
██                                                                                                                                                                                                                               ██
██                                                                                                                                                                                                                               ██
██      ╔═══════════════╗                                                                                                                                                                                                        ██
██      ║               ║                                                                                                                                                                                                        ██
██      ║               ║                                                                                                                                ╔══════════════════════════════╗                                        ██
██      ╟─────░░░░░─────╢                                                                                                                                ║                              ║                                        ██
██      ║               ║         ╔═══════════════╗                                                                                                      ║                              ║                                        ██
██      ║               ║         ║               ║                                                                                                      ║                              ║                                        ██
██      ║               ║         ║               ╚════════════╗                                                                                         ║                              ║                                        ██
██      ║               ║         ║                            ║                                                                                         ║                              ║                                        ██
██      ║               ║         ║                            ║                                                                                         ║                              ║                                        ██
██      ║               ║         ║               ╔══════╗     ║                                                                                         ║                              ║                                        ██
██      ║               ║         ║               ║      ║     ║                                                                                         ║                              ║                                        ██
██      ║               ║         ╚════╗     ╔════╝      ║     ║                                                                                         ║                              ║                                        ██
██      ║               ║              ║     ║           ║     ║                                                                                         ║                              ║                                        ██
██      ║               ║             ░░░░░░░░░          ║     ║                                                                                         ║                              ║                                        ██
██      ║               ║              ║     ║           ║     ║                                                                                         ║                              ║                                        ██
██      ║               ╚══════════════╝     ║           ║     ║    ╔═══════════════╗                                                                    ║                              ║                                        ██
██      ║                                    ║           ║     ║    ║               ║                                                                    ║                              ║                                        ██
██      ║                                    ║           ║     ║    ║               ╚══════════════════════════════════════════════════════════════░░════╝                              ╚══░░═════════╗                          ██
██      ║               ╔════════════════════╝           ║     ║    ║                                                                              ░░                                      ░░         ║                          ██
██      ║               ║                                ║     ║    ║       X                                                                      ░░                                      ░░         ║                          ██
██      ║               ║                                ║     ║    ║               ╔══════════════════════════════╗      ╔════════════════════════░░════╗                              ╔══░░══╗      ║                          ██
██      ║               ║                                ║     ║    ║               ║                              ║      ║                              ╚══════════════════════════════╝      ║      ║                          ██
██      ║               ║                                ║     ║    ╚═══════════════╝                              ║      ║                                                                    ║      ║                          ██
██      ╚═══════════════╝                                ║     ║                                                   ║      ║                                                                    ║      ║                          ██
██                                                       ║     ║                                                   ║      ║                                                                    ║      ║                          ██
██                                                       ║     ║                                                   ║      ║                                                                    ║      ║                          ██
██                                                       ║     ║                                                   ║      ║                                                                    ║      ║                          ██
██                                                       ║     ║                                                   ║      ║                                                                    ║      ║                          ██
██                                                       ║     ║                                                   ║      ║                                                                    ║      ║                          ██
██                                                       ║     ╚═══════════════════════════════════════════════════╝      ║                                                                    ║      ║                          ██
██                                                       ║                                                                ║                                                                    ║      ║                          ██
██                                                       ║                                                                ║                                                                    ║      ║                          ██
██                                                       ╚════════════════════════════════════════════════════════════════╝                                                                    ║      ║                          ██
██                                                                                                                                                                                             ║      ║                          ██
██                                                                                                                                                                                             ║      ║                          ██
██                                                                                                                                                                                             ║      ║      ╔═══════════════╗   ██
██                                                                                                                                                                                             ║      ║      ║               ║   ██
██                                                                                                                                                                                             ║      ╚══════╝               ║   ██
██                                                                                                                                                                                             ║                             ║   ██
██                                                                                                                                                                                             ║                             ║   ██
██                                                                                                                                                                                             ║      ╔══════╗               ║   ██
██                                                                                                                                                                                             ║      ║      ║               ║   ██
██                                                                                                                                                                                             ║      ║      ╚═══════════════╝   ██
██                                                                                                                                                                                             ║      ║                          ██
██                                                                                                                                                                                             ║      ║                          ██
██                                                                                                                                                                                             ║      ║                          ██
██                                                                                                                                                                                             ║      ║                          ██
██                                                                                                                                                                                             ║      ║                          ██
██                                                                                                                                                                                             ║      ║                          ██
██                                                                                                                                                                                             ║      ║                          ██
██                                                                                                                                                                                             ║      ║                          ██
██                                                                                                                                                                                             ║      ║                          ██
██                                                                                                                                                                                             ║      ║                          ██
██                                                                                                                                                                                             ║      ║                          ██
██                                                                                                                                       ████████████████████████████████                      ║      ║                          ██
██                                                                                                                                       ██                            ██                      ║      ║                          ██
██                                                                                                                                       ██                            ██                      ║      ║                          ██
██                                                                                                                                       ██                            ██══════════════════════╝      ║                          ██
██                                                                                                                                       ██                                                           ║                          ██
██                                                                                                                                       ██                                                           ║                          ██
██                                                                                                                                       ██                            ██═════════════════════════════╝                          ██
██                                                                                                                                       ████████████████████████████████                                                        ██
██                                                                                                                                                                                                                               ██
██                                                                                                                                                                                                                               ██
███████████████████████████████████████████████████████████████████████████████████████████████████████████████████████████████████████████████████████████████████████████████████████████████████████████████████████████████████